####################
#@...#....#.#....O.#
#......##...#.#.##.#
#......##...#.#.##.#
#####.######..#.#..#
#.....#...#...#.#.##
#.....#...#..#..#.##
#.#####.#...#.O.#..#
#.#......#######G..#
#.#......#.....#...#
#.#.###S...#.#.#.###
#.....##...#...#...#
#.....##.......#.D.#
####################